NO ./textures/north.xpm
SO ./textures/south.xpm
WE ./textures/west.xpm
EA ./textures/east.xpm
F             220,100,0
C  225,30,0
1                 1          
10                   001
10N              01           
10001                       
11111                        
